111111111111111111111111
1000C0000000000000000001
1000P000000000000C00E001
100000000110000000000001
10000000000c000011000001
10000C000000000000000001
1000001111111100000C0001
111111111111111111111111