11111111111111
10000000000001
10000C00000001
10000000E00001
10000C00000001
10000000P00001
10000000000001
10000C00000001
10000C00011111
10000000010001
10000000011011
11111111111111