1111111111111111
1000000000000001
10000C0000000001
1000000000000001
10000C0000000001
1000000000000001
10E0000000000001
10000C0000000001
10000C0000000001
10000000000P0001
1000000000000001
1111111111111111