11111111
10E0CPC1
10C000C1
10C000C1
10C000C1
10N00001
1000N001
10CN0001
11111111