11111111
10C01001
1P000E01
11111111