11111111
10000001
1P000C01
1000E001
11111111