1111111111
10P00C0E01
1111111111
