11111111111111111111111111
100000000E0000000000000001
1P000C0C0C0C00000000000001
10000000000000000000000001
11111111111111111111111111