11111111111111
10E000P00000C1
100000N0000001
11111111111111