11111111111111111111
100000000N0000000001
1000000000N000000001
1P000C00C00C00C00C01
1000E000000000000001
11111111111111111111